NO ./textures/red_brick.png
EA ./textures/purplestone.png
SO ./textures/steel_door.png
WE ./textures/blue_wall.png
F 0,200,0
C 0,0,200

111111111111000
100110010001000
100110010001000
100N00000001111
100010000000001
100100010000001
100000010000001
111111111111111