



WE       ./textures/planks.png
EA    ./textures/east.png
SO     ./textures/south.png

NO ./textures/north.png



F 0,200,0

C 0,0,200

  111111101111111
  100110010000001  
  100110010000001  
  100N00000000001  
  100000000000001  
  100000010000001  
  100000010000001  
  111111111111111  
