EA ./textures/east.png
WE ./textures/west.png
NO ./textures/north.png
SO ./textures/south.png

F 50,0,0
C 0,0,50

11111111
10011001
10011001
10000001
10000001
10000001
10000001
11111111