



WE       ./textures/planks.png
EA    ./textures/east.png
SO     ./textures/south.png

NO ./textures/north.png



F 100,200,100

C 100,100,200

111111
111101
100N11
111111