WE       ./textures/planks.png
EA    ./textures/east.png
SO     ./textures/south.png
NO ./textures/north.png
C 135,206,235
F 0,128,0

111111111111110
100000000000001
111111101111111
111100000001111
111111111101111
111100000000111
100001000000001
100000000011111
111110000011111
111111000000111
111000000011111
111110000001111
110000011111111
111110000001111
111111111011111
111111111S11111
111111111111111

