EA ./textures/east.png
WE ./textures/planks.png
NO ./textures/north.png
SO ./textures/south.png

F 0,200,0
C 0,0,200

111111111111111
10W110010000001
100110010000001
100000000000001
100000000000001
100000010000001
100000010000001
111111111111111
