WE   ./textures/planks.png
C 135,206,235
SO     ./textures/south.png
NO ./textures/north.png

F 10,128,0
EA    ./textures/east.png

  111111111111110
  100000000000001
  111111101111111
  111100000001111
  111111111101111
  111100000000111
  100001000S000001
111           111
100000000011111
111110000011111
111111000000111
111000000011111
111110000001111
111111111111111
