11111111
100110N1
10011001
10000001
10000001
10000001
10000001
11111111